000000000000000000000000000000000000
111111111000000000000000000000000000
111111111000111111111111111000000000
111111111000111111111111111000000000
000000111000111111111111111000000000
000000111000111000000000111000000000
000000111000111000000000111000000000
000000111000111000000000111000000000
000111111000111000000000111000000000
000111111000111000000000111000111111
000111111000111000111111111000111111
000111000000111000111111111000111111
000111000000111000111111111000111000
000111000000111000111000000000111000
000111000000111000111000000000111000
000111111111111000111111111111111000
000111111111111000111111111111111000
000111111111111000111111111111111000
000000000000000000000000000000000000
