000000000000000000000000000000000000
111111111111111000000000000000000000
111111111111111000000000000000000000
111111111111111000000000000000000000
000000000000111000000000000000000000
000000000000111000000000000000000000
000000000000111000000000000000000000
000000000000111000000000000000000000
000000000000111000000000000000000000
000000000000111000000000000000000000
000000000000111000000000000000000000
000000000000111000000000000000000000
000000000000111000000000000000000000
000000000000111000000000000000000000
000000000000111000000000000000000000
000000000000111111111111111111111111
000000000000111111111111111111111111
000000000000111111111111111111111111
000000000000000000000000000000000000
